R 1000 800

S sprites/kitty.xpm
NO textures/base/no.xpm
SO textures/base/so.xpm
WE textures/base/we.xpm
EA textures/base/ea.xpm

C 60, 74, 81
F 20, 20, 255

11111111
10100001
10020001
10000001
10001001
10010101
12001001
12000001
100N0001
11111111