R 1000 1000

S sprites/kitty.xpm
NO textures/base/no.xpm
SO textures/base/so.xpm
WE textures/base/we.xpm
EA textures/base/ea.xpm

C 60, 74, 81
F 20, 20, 255

1111111111111
1010000000001
1002000000001
1000000000001
1000100000001
1001010000001
1200100000001
1200000000001
100N000000001
1111111111111