R 640 480

NO textures/textureNO.xpm
SO textures/textureSO.xpm
WE textures/textureWE.xpm
EA textures/textureEA.xpm
S sprites/sprite.xpm

F 255, 127, 100
C 255, 128, 110

        1111111111111111111111111
        1000000000111000000000001
        1011000001111000002000001
        1001000000000001000000001    11111
111111111011000000111000000000001    10001
100000000011000001110111111111111    10001
11110111111111011100000010001        11111
11110111111111011101010010001       
11000000110101011100000010001
10002000010000001100000010101
10000000000000001101100010001
1100000111010101111101111010111
1111011101110101 1111010N0011
1111111111111111 111111111111