R 800 600

F 255, 126, 111                             
C 254, 128, 110

S sprites/sprite.xpm
NO textures/textureNO.xpm
SO textures/textureSO.xpm
WE textures/textureWE.xpm
EA textures/textureEA.xpm



        1111111111111111111111111
        10000000001110000000000W1
        1011000001111000002000001
        1001000000000001000000001 
111111111011000000111000000000001 
100000000011000001110000111111111 
11110111111111011100000010001     
11110111111111011101010010001       
11000000110101011100000010001
10002000010000001100000010101
10000000000000001101100010001
1100000111010101111101111010111
1111011101110101 111101000011
1111111111111111 111111111111