R 800 600

S sprites/sprite.xpm

NO textures/textureNO.xpm
SO textures/textureSO.xpm
WE textures/textureWE.xpm
EA textures/textureEA.xpm

F 40, 40, 40                            
C 255, 154, 141

1111111111111111111111111
1000000000000100000000001
1000000000000000000000001
1000000000000000000000001 
1000000000000W00000000001 
1111111111111111111111111

        1111111111111111111111111
        1000000000111000000000001
        1011000001111000002000001
        1001000000000001000000001
111111111011000000111000000000001
100000000011000001110000111111111
10000011111111101110000001001 
10000011111111101110101001001    
10000000110101011100000010001
10000000010000001100000010101
10000000000000001101100010001
1000000111010101111101111010111
1111111111110101 111101000011
1111111111111111 111111111111