R 640 480

NO textures/textureNO.xpm
SO textures/textureSO.xpm
WE textures/textureWE.xpm
EA textures/textureEA.xpm
S sprites/sprite.xpm

F 255, 127, 10
C 255, 128, 110

        1111111111111111111111111
        1000000000110000000000001
        1011000001110000002000001
        1001000000000000000000001    11111
111111111011000000111000000000001    10001
100000000011000001110111111111111    1N001
11110111111111011100000010001        11111
11110111111111011101010010001       
11000000110101011100000010001
10002000010000001100000010101
10000000000000001101010010001
1100000111010101111101111010111
11110111 1110101 111101000011
11111111 1111111 111111111111