R 800 600

S sprites/kianu.xpm
NO textures/cyber/bigdoor.xpm
SO textures/cyber/cement2.xpm
WE textures/cyber/cement3.xpm
EA textures/cyber/cement4.xpm

AS sprites/woman.xpm
SK textures/cyber/cyber.xpm
FT textures/cyber/floor.xpm
WP textures/cyber/weapon.anim
MC music/cyber.mp3
SD music/wtfu.mp3
WS music/bullet.mp3

F 255, 154, 141
C 60, 74, 81 

1111111111111111111111111
1000000000N00033300000001      1111
1000000010000000000000001      1001
10000001120000T0000000001      1111
1111100202020000000000001
1111111111111111111111111
        1111111111111111111111111
        1000000000000000000000001
        1011000000000000000000001
        1001000000000H00000000001
111111111011000000000000000000001
100000000011000000000000000111111
10000011111111101110000001001 
10000011111111101110101001001    
10000000110101011100000010001
10000000010000001100000010101
10000000000000001101100010001
1000000111010101111101111010111
1111111111110101 111101000011
1111111111111111 111111111111