R 600 500

S sprites/kianu.xpm
NO textures/cyber/bigdoor.xpm
SO textures/cyber/cement2.xpm
WE textures/cyber/cement3.xpm
EA textures/cyber/cement4.xpm

AS sprites/chip.xpm
SK textures/cyber/cyber.xpm
CT textures/cyber/floor.xpm
FT textures/cyber/floor.xpm
WP textures/cyber/pistol.anim
TP textures/cyber/tp.anim
DG textures/digits.anim
KS music/pickup.mp3
MC music/cyber.mp3
SD music/wtfu.mp3
WS music/pistol.mp3
NL maps/oblivion.cub

F 255, 154, 141
C 60, 74, 81 

1111111111111111111111111
1000000000N00000000000001      1111111
1000000010003000000000001      1000001
10000001100000T0000000001      1002001
1011100000000000000000001      1000001
1011111111111111111111111      1011111
101                            101
101     11111111111111111111111101
111     10000000000000000000000001
        10110002000000000000000011
        10010000000000H0000000001
111111111011000200000000000000001
100000000011000000000000000011111
10000011111111101110000001001 
10000011111111101110101001001    
10000000110101011100000010001
10000000010000001100000010101
10000000000000000001100010001
10000001110101011111001110101
11111111111101000000001000O11
11111111111111111111111111111