R 800 600

S  sprites/idk.xpm
NO textures/oblivion/obl15.xpm
SO textures/oblivion/obl9.xpm
WE textures/oblivion/obl10.xpm
EA textures/oblivion/obl12.xpm

AS textures/oblivion/light.xpm
SK textures/oblivion/back_shining.xpm
FT textures/oblivion/obl7.xpm
WP textures/oblivion/weapon.anim
WS music/arrow.mp3
MC music/oblivion.mp3
SD music/idk.mp3

F 255, 154, 141
C 60, 74, 81

        11111111111
       1100000000011
      110001110110111
    1110000101001000111111111111111
  111000000000000000000000000011111
 1100011110110111011001111110000001
11000011010110111011101111110111001
10000000000000000000000011110111001
1000000010003000000000001  101 1001
1000000112000011100000001  10111001
11111002010000100000000011110111001
11111111110000211111110000000000001
        110000211111111111111111111
        10033333331110000000000001
        10110333331111000000000001
        10010000000000010000000011
1111111110110S0000111000000000001
100000000011000001110000111111111
10000011111111101110000001001 
10000011111111101110101001001    
10000000110101011100000010001
10000000010000000000000010101
10000000000000001101100000001
1000000111010101111101111010111
1111111111110101 111101000011
1111111111111111 111111111111